22222222222200002222220000000000000000000000000000000000000000000000
21111111111200002111120000000000000000000002222222222222222222222200
24870807073222222400322222222222000000000002111111111111111111111200
24800000003211111100111111111112000000000002470870808007700708003200
24000000003240077000808770870032000000000002400800808000000008003200
24060066003240600000808000000632000000000002400800008000060060663200
21111111003211110000008000001112222222222222400000000000111111111200
22222224003111110000000000001111111111111111100000060000708732222200
00000024003408080000060006000007787080700807000000011100008032000000
00000024001108000000111111000000080080000800000000012106008032000000
00000024000700006000322224006000660000006060666001112111000032000000
00000024000000111100320021111111111111111111111111222224000032000000
00000024600066322400320022222222222222222222222222200024000032000000
00000021111111122400320000000000000000000000000000000024000032000000
00000022222222222400320000000000000000000000000000000024000032000000