000000000000000000000000000000000000000000000
000000000000000000000000000000000000000000000
000011000000000000000000000000011110000011000
000011000000000000000000000000000000000000000
000000000000000001110000000000000000000000000
000000000000000001110000000000000000000000000
000000000011000000000000000000000000000011000
000000000011000000000000000000000000000011000
000000000000000000000000000000000000000011000
000000000000000000000000000000000000000000000
000000111100000000000000000000000000000000000
000000111100000000000000011100000111110000000
000000000000000000000000011100000000000000000
000000000000000000000000000000000000000000000
000000000000000000000000000000000000000000000