00000240000032403403200000000024000000003200000240000000000000000032
00000240000032403403222222222224000000003200000240000000000000000032
00000240000032403403211111111111000000003222222240000000000000000032
22222240000032403403247800878700000000001111111110000000000000000032
21111110000032403403240800808000000000000078008700000000000000000032
24870800000032403403240800800066000000000008008000000000000000000032
24800800660032403403240800000111000000006060008000000000000000000032
24800011110032403403240000060324000000001110000000000000000000000032
24060632240011101101110000011124000000003240000000000000000000060632
21111112240007807008000000032224000000003246600060000000000001111112
22222222246006060000660600032024000000003211111110000000000003222222
00000000211111111111111111112024000000003222222240000000000003200000
00000000222222222222222222222024000000003200000240000000000003200000
00000000000000000000000000000024000000003200000240000000000003200000
00000000000000000000000000000024000000003200000240000000000003200000