002222222222222222222222222222222222222222222
002111111111111111111111111111111111111111112
002470700708087707087088008000000707808870032
002400000008080000080008000000666000800860632
002460660008000000000008000001111111100111112
002111111000000000000000000000707808000780832
002222224000006600600006600600000808000080832
222222224000001111100111111111100800000000832
211111111000003222400000032222400111100000032
240780007000063202400000032222400007700006632
240080000000111202400000011111100000000111112
240000000000322202400000080780800000000322222
246000066006320002460000000680000606000320000
211111111111120002111111111110011111111120000
222222222222220002222222222240032222222220000